BLY..bly
.R....r.
........
ww...ddd
www...dd
wwd...mm
dd..mmmm
d..mmmmm
