wwwwmm..
.wwwwm..
..mww..b
B..mw.rl
LR..m..y
Y....d..
...dddd.
....dd..
